NO Textures/quarzo1.png
SO Textures/quarzo2.png
WE Textures/quarzo3.png
EA Textures/quarzo4.png

F 124,124,124
C 112,112,235

1111111111111111111111111
1000000000110000000000001
1011000001110000000000001
10010000000000000000000011111111
111111111011000001110000000000001
10000000001100000111011111111111
11110111111111011100000010001        111
11110111111111011101010010001        101
11000000110101011100000010001        111
10000000000000001100000010001
1000N000000000000000000000001
11111111111111111111111111111
1000000000000000110101001000111
1100000111010101111101111000011
11110101 1110101 101111010001
1111111  1111111 11111111111